NO                        ./textures/425.xpm


F 32,32,32


C 0,0,102
EA ./textures/425.xpm
WE ./textures/425.xpm

SO ./textures/425.xpme

    11111
    10001
    10S01
    10001
    10001
    1000011111111111
    11001
    10001
    10001
    10001
    10001
    10001
    11111


