NO ./img/20.xpm
EA ./img/20.xpm
WE ./img/20.xpm
SO ./img/20.xpm

F 247,248,250


C 0,0,102



111111111111111111111
100000000000000000001
100000011111110000001
100000000000000000001
100000000000001000001
100000000000000000001
100000011111110000001
100000000000000000001
100000000000000000001
100000000000000000001
100000000000000000001
100000000000000000001
100000000000000000001
100000000000000000001
100000000000000000001
100000000000000000001
100000000000000000001
1000000000N0000000001
100000000000000000001
100000000000000000001
111111111111111111111



