


						NO ./bonus/textures/north_face.xpm
    SO ./bonus/textures/north_face.xpm
    	     	    EA ./bonus/textures/north_face.xpm
	WE ./bonus/textures/north_face.xpm









       F 32, 32, 32
				C 0, 0, 102

11111111
10000001
100N0001
11000001
11111111