NO ./bonus/textures/north_face.xpm
EA ./bonus/textures/east_face.xpm
WE ./bonus/textures/west_face.xpm
SO ./bonus/textures/south_face.xpm

F 0,128,0


C 0,196,255



111111111111111111111
100000000000000000001
100000011111110000001
100000000000000000001
100000000000001000001
100000000000000000001
10000001111D110000001
100000000000000000001
10000000000N000000001
100000000000000000001
100000000000000000001
100000000000000000001
100000000000000000001
100000000000000000001
100000000000000000001
100000000000000000001
100000000000000000001
100000000000000000001
100000000000000000001
100000000000000000001
100000000000000000001
100000000000000000001
100000000000000000001
100000000000000000001
100000000000000000001
100000000000000000001
100000000000000000001
100000000000000000001
100000000000000000001
100000000000000000001
100000000000000000001
100000000000000000001
100000000000000000001
100000000000000000001
100000000000000000001
100000000000000000001
100000000000000000001
100000000000000000001
100000000000000000001
100000000000000000001
100000000000000000001
111111111111111111111



