NO ./bonus/textures/north_face.xpm
EA ./bonus/textures/east_face.xpm
WE ./bonus/textures/west_face.xpm
SO ./bonus/textures/south_face.xpm

F 0,128,0
C 0,196,255

11111
10001
10N01
10001
11D11
11111
	
11111
10001
11111   