NO ./bonus/textures/north_face.xpm
EA ./bonus/textures/east_face.xpm
WE ./bonus/textures/west_face.xpm
SO ./bonus/textures/south_face.xpm

F 0,128,0


C 0,196,255



111111111111111111111
100000000000000000001
100000011111110000001
10000000000000D000001
100000000000001000001
100000000000000000001
1000000111D1110000001
100000000000000000001
100000000000000000001
100000000000000000001
1000000000N0000000001
100000000000000000001
100000000000000000001
100000000000000000001
1000001D1000000000001
100000000000000000001
100000000000000000001
100000000000000000001
100000000000000000001
10000000001D100000001
100000000000000000001
100000000000000000001
100000000000000000001
1000001D1000000000001
100000000000000000001
100000000000000000001
100000000000000000001
100000000000000000001
10000000000001D100001
100000000000000000001
100000000000000000001
100000000000000000001
100000000000000000001
100000000000000000001
100000000000000000001
100000000000000000001
100000000000000000001
100000000000000000001
100000000000000000001
100000000000000000001
100000000000000000001
111111111111111111111



