NO ./bonus/textures/north_face.xpm
EA ./bonus/textures/east_face.xpm
WE ./bonus/textures/west_face.xpm
SO ./bonus/textures/south_face.xpm

F 0,128,0
C 0,196,255

111111111111111
122200000000001
10S200000000001
100222200000001
100000200000001
100000222000001
11111111D111111
100000002000001
100000002220001
100000000020001
100000000020001
100000000022201
100000000000021
100000000000021
100000002220001
100000000020001
100000000020001
100000000022201
100000000000021
100000000000021
111111100111111
100000002220001
100000000020001
100000000020001
100000000022201
100000000000021
100000000000021
111111111111111